+-----------------------------------------------------------------+
| New SWML Script                                              x  |
+-----------------------------------------------------------------+
|                                                                 |
| Name - Optional                                                 |
| +-------------------------------------------------------------+ |
| | my-agent                                                    | |
| +-------------------------------------------------------------+ |
|                                                                 |
| Primary Script                                                  |
|                                                                 |
| Handle Calls Using                                              |
| +-------------------------------------------------------------+ |
| | External URL                                             v  | |
| +-------------------------------------------------------------+ |
|                                                                 |
| Primary Script URL                                              |
| +-------------------------------------------------------------+ |
| | https:∕∕user:pass@your-name.ngrok-free.app∕agent            | |
| +-------------------------------------------------------------+ |
|                                                                 |
| Fallback Script URL - Optional                                  |
| +-------------------------------------------------------------+ |
| |                                                             | |
| +-------------------------------------------------------------+ |
|                                                                 |
| Status Change Webhook URL - Optional                            |
| +-------------------------------------------------------------+ |
| |                                                             | |
| +-------------------------------------------------------------+ |
|                                                                 |
| [Cancel]                                            [Create]    |
+-----------------------------------------------------------------+
